7 7
0 5 5 0 5 1 0 
0 0 0 0 0 0 4 
0 0 0 0 0 0 0 
0 0 0 0 4 0 0 
1 1 0 4 0 0 0 
0 0 0 0 0 0 0 
0 0 1 3 0 4 0 
120
